You sigh and hang up the phone. This morning you had been looking forward to kicking back with a cold lemonade and a game of Super Mario 64. Now the vet has reminded you that your cat has a routine checkup in half an hour. Normally affable and outgoing, your large furry tabby cat understands English and the minute he heard the word "vet" he made himself scarce. Now you have to chase him through the house and capture him. You aren't looking forward to the struggle.

Get That Cat!
Steel Cage Match by Douglas Kiang The release number is 1
Release 1 / Serial number 130228 / Inform 7 build 6G60 (I6/v6.32 lib 6/12N) SD

Living Room
This room is largeish, with a bank of sunny windows next to the door to the patio facing the street outside. There are lots of places a cat could hide, especially a cat who does not want to go to the vet. The hallway is to the south, and the kitchen is to the east.

You can see a pappasan, Sam, and a newspaper here.

>x sam
Sam is a black and white cat.

Sam heads to the Hallway.

[Your score has just gone up by one point.]

>s
Hallway
The carpet in the hallway is worn from the scuffling of furry cat feet as they run rapidly from room to room for no apparent reason. The bathroom is to the south and the living room is to the north. There are stairs here that lead up to the attic.

You can see Sam and a cat carrier (empty) here.

Sam heads to the Bathroom.

>s
Bathroom
The bathroom is small, just large enough to hold a mirror, the sink, the shower, and the toilet.

Opposite the mirror is the shower, which is closed.

You can also see a tabby cat and Sam here.

Sam heads to the Hallway.

>n
Hallway
The carpet in the hallway is worn from the scuffling of furry cat feet as they run rapidly from room to room for no apparent reason. The bathroom is to the south and the living room is to the north. There are stairs here that lead up to the attic.

You can see Sam and a cat carrier (empty) here.

Sam heads to the Bathroom.

>x sam
You can't see any such thing.

>e
You can't go that way.

Sam arrives from the Bathroom.

>x sam
Sam is a black and white cat.

You hear a horrible choking and hacking sound. Somewhere, someone has coughed up a hairball.

Sam heads to the Attic.

You realize that you have only ten more minutes to get the cat into his carrier.

* * *

>take newspaper
Taken.

Sam heads to the Hallway.

>x newspaper
It is called the Englewood Times. There are all sorts of stories about traffic congestion in New Jersey, the hot, sticky weather, the Yankees losing to the Red Sox, what the heck is a pappasan? and so on, and so forth...

[Your score has just gone up by one point.]

>e
Kitchen
The kitchen is a bright, sunny room. A wraparound counter provides a place to stand up and eat, and the smell of freshly baked chocolate chip cookies wafts through the air. The tiles on the kitchen floor are faded and chipped from the sunlight. This is clearly the most popular room in the house. The living room is to the west of you.

You can see an Oven (closed) and a Cabinet (closed) here.

You hear a horrible choking and hacking sound. Somewhere, someone has coughed up a hairball.

>x oven
An old working model from the 1970s, it is used but serviceable. In fact, it has to be serviced all the time.

[Your score has just gone up by one point.]

>smell
You smell nothing unexpected.

There is a large furry tabby cat here.

>take cat
You look at his claws and teeth and think otherwise. The vet doesn't carry Band-Aids.

You hear a horrible choking and hacking sound. Somewhere, someone has coughed up a hairball.

>open oven
A blast of hot air and the aroma of soft, chewy chocolate chip cookies greets you as you peer eagerly into the hot oven.

>take cookies
You'll need something to protect your hands!

>open cabinet
You open the Cabinet, revealing a pair of Potholders.

>x cabinet
The cabinet stores pots, pans, and other cooking implements.

In the Cabinet is a pair of Potholders.

[Your score has just gone up by one point.]

>take potholders
There is a large furry tabby cat here.

[Your score has just gone up by one point.]

>x cabinet
The cabinet stores pots, pans, and other cooking implements.

There is a large furry tabby cat here.

[Your score has just gone up by one point.]

>take cat
You look at his claws and teeth and think otherwise. The vet doesn't carry Band-Aids.

There is a large furry tabby cat here.

>put on potholders
You put on the pair of Potholders.

There is a large furry tabby cat here.

>take cat
Taken.

The tabby cat kicks and squirms. It is hard to carry him.

>w
Living Room
This room is largeish, with a bank of sunny windows next to the door to the patio facing the street outside. There are lots of places a cat could hide, especially a cat who does not want to go to the vet. The hallway is to the south, and the kitchen is to the east.

You can see a pappasan here.

The tabby cat kicks and squirms. It is hard to carry him.

>s
Hallway
The carpet in the hallway is worn from the scuffling of furry cat feet as they run rapidly from room to room for no apparent reason. The bathroom is to the south and the living room is to the north. There are stairs here that lead up to the attic. The bedroom is to the west of the hallway.

You can see a cat carrier (empty) here.

Sam arrives from the Bathroom.

The tabby cat kicks and squirms. It is hard to carry him.

>put cat in cat carrier
(the tabby cat in the cat carrier)
You put the tabby cat into the cat carrier.

Sam heads to the Living Room.

You win!

    *** You have won ***

In that game you scored 5 out of a possible 20, in 18 turns.

Would you like to RESTART, RESTORE a saved game, QUIT or UNDO the last command?

* * *

>look at windows
The windows are big and bright and look out on West Ivy Lane. Your beat-up maroon station wagon is idling outside, waiting for you to load the cat into the car.

Sam heads to the Kitchen.

There is a large furry tabby cat here.

* * *

>look out windows
I only understood you as far as wanting to look outside.

>look at windows
The windows are big and bright and look out on West Ivy Lane. Your beat-up maroon station wagon is idling outside, waiitng for you to load the cat into the car.

You hear a horrible choking and hacking sound. Somewhere, someone has coughed up a hairball.

Sam heads to the Hallway.

>look at window
You can't see any such thing.

>e
Kitchen
The kitchen is a bright, sunny room. A wraparound counter provides a place to stand up and eat, and the smell of freshly baked chocolate chip cookies wafts through the air. The tiles on the kitchen floor are faded and chipped from the sunlight. This is clearly the most popular room in the house. The living room is to the west of you.

You can see an Oven (closed) and a Cabinet (closed) here.

>look at counter
You can't see any such thing.

I beg your pardon?

* * *

>x pappasan
What more is there to say? It's a pappasan.

Sam heads to the Hallway.

>x newspaper
It is called the Englewood Times. There are all sorts of stories about traffic congestion in New Jersey, the hot, sticky weather, the Yankees losing to the Red Sox, what the heck is a pappasan? and so on, and so forth...

[Your score has just gone up by one point.]

>sit on pappasan
You have a seat on the pappasan. It creaks and flexes. Ahhhhhh... But this is no time to relax! There's a cat to catch!

[Your score has just gone up by one point.]

* * *

>look under pappasan
You find nothing of interest.

Sam heads to the Hallway.

* * *

>s
Hallway
The carpet in the hallway is worn from the scuffling of furry cat feet as they run rapidly from room to room for no apparent reason. The bathroom is to the south and the living room is to the north. There are stairs here that lead up to the attic. The bedroom is to the west of the hallway.

You can see a cat carrier (empty) here.

Sam arrives from the Living Room.

>w
Bedroom
The bedroom is just big enough for a king-sized bed. There is a big blue armoire that holds clothes, and a closet in the corner. A bright sunny window looks out over the lawn. The only exit leads back east to the Hallway.

You can see an armoire (empty) and a bed here.

>gte in bed
That's not a verb I recognise.

>get in bed
Ahhhh! It feels so nice to lie down. But shouldn't you be trying to Get That Cat?

There is a large furry tabby cat here.

>restart
Are you sure you want to restart?

* * *

>s
Hallway
The carpet in the hallway is worn from the scuffling of furry cat feet as they run rapidly from room to room for no apparent reason. The bathroom is to the south and the living room is to the north. There are stairs here that lead up to the attic. The bedroom is to the west of the hallway.

You can see a cat carrier (empty) here.

Sam arrives from the Living Room.

>e
You can't go that way.

>n
Living Room
This room is largeish, with a bank of sunny windows next to the door to the patio facing the street outside. There are lots of places a cat could hide, especially a cat who does not want to go to the vet. The hallway is to the south, and the kitchen is to the east.

You can see Sam, a pappasan, and a newspaper here.

Sam heads to the Hallway.

>e
Kitchen
The kitchen is a bright, sunny room. A wraparound counter provides a place to stand up and eat, and the smell of freshly baked chocolate chip cookies wafts through the air. The tiles on the kitchen floor are faded and chipped from the sunlight. This is clearly the most popular room in the house. The living room is to the west of you.

You can see an Oven (closed) and a Cabinet (closed) here.

>open cabinet
You open the Cabinet, revealing a pair of Potholders.

>wear potholders
(first taking the pair of Potholders)
You put on the pair of Potholders.

[Your score has just gone up by one point.]

>w
Living Room
This room is largeish, with a bank of sunny windows next to the door to the patio facing the street outside. There are lots of places a cat could hide, especially a cat who does not want to go to the vet. The hallway is to the south, and the kitchen is to the east.

You can see a tabby cat, a pappasan, and a newspaper here.

The large furry tabby cat leaves.

>s
Hallway
The carpet in the hallway is worn from the scuffling of furry cat feet as they run rapidly from room to room for no apparent reason. The bathroom is to the south and the living room is to the north. There are stairs here that lead up to the attic. The bedroom is to the west of the hallway.

You can see Sam and a cat carrier (empty) here.

Sam heads to the Bedroom.

>s
Bathroom
The bathroom is small, just large enough to hold a mirror, the sink, the shower, and the toilet.

Opposite the mirror is the shower, which is closed.

You can also see a tabby cat here.

The large furry tabby cat leaves.

>n
Hallway
The carpet in the hallway is worn from the scuffling of furry cat feet as they run rapidly from room to room for no apparent reason. The bathroom is to the south and the living room is to the north. There are stairs here that lead up to the attic. The bedroom is to the west of the hallway.

You can see Sam and a cat carrier (empty) here.

You hear a horrible choking and hacking sound. Somewhere, someone has coughed up a hairball.

Sam heads to the Bedroom.

>up
Attic
The attic smells musty and is filled with junk. It is a large room that spans the entire house. There are a million places a cat could hide. The stairs lead down to the hallway.

>d
Hallway
The carpet in the hallway is worn from the scuffling of furry cat feet as they run rapidly from room to room for no apparent reason. The bathroom is to the south and the living room is to the north. There are stairs here that lead up to the attic. The bedroom is to the west of the hallway.

You can see a tabby cat, Sam, and a cat carrier (empty) here.

Sam heads to the Attic.

The large furry tabby cat leaves.

>w
Bedroom
The bedroom is just big enough for a king-sized bed. There is a big blue armoire that holds clothes, and a closet in the corner. A bright sunny window looks out over the lawn. The only exit leads back east to the Hallway.

You can see a tabby cat, an armoire (empty), and a bed here.

The large furry tabby cat leaves.

>e
Hallway
The carpet in the hallway is worn from the scuffling of furry cat feet as they run rapidly from room to room for no apparent reason. The bathroom is to the south and the living room is to the north. There are stairs here that lead up to the attic. The bedroom is to the west of the hallway.

You can see Sam and a cat carrier (empty) here.

Sam heads to the Living Room.

>n
Living Room
This room is largeish, with a bank of sunny windows next to the door to the patio facing the street outside. There are lots of places a cat could hide, especially a cat who does not want to go to the vet. The hallway is to the south, and the kitchen is to the east.

You can see Sam, a pappasan, and a newspaper here.

Sam heads to the Hallway.

There is a large furry tabby cat here.

>take cat
Taken.

The tabby cat kicks and squirms. It is hard to carry him.
With a supreme effort and a baleful look, the tabby cat escapes from your grasp.

>s
Hallway
The carpet in the hallway is worn from the scuffling of furry cat feet as they run rapidly from room to room for no apparent reason. The bathroom is to the south and the living room is to the north. There are stairs here that lead up to the attic. The bedroom is to the west of the hallway.

You can see a cat carrier (empty) here.

Sam arrives from the Attic.

>s
Bathroom
The bathroom is small, just large enough to hold a mirror, the sink, the shower, and the toilet.

Opposite the mirror is the shower, which is closed.

>n
Hallway
The carpet in the hallway is worn from the scuffling of furry cat feet as they run rapidly from room to room for no apparent reason. The bathroom is to the south and the living room is to the north. There are stairs here that lead up to the attic. The bedroom is to the west of the hallway.

You can see a cat carrier (empty) here.

Sam arrives from the Bedroom.

>n
Living Room
This room is largeish, with a bank of sunny windows next to the door to the patio facing the street outside. There are lots of places a cat could hide, especially a cat who does not want to go to the vet. The hallway is to the south, and the kitchen is to the east.

You can see a pappasan and a newspaper here.

Sam arrives from the Hallway.

There is a large furry tabby cat here.

>e
Kitchen
The kitchen is a bright, sunny room. A wraparound counter provides a place to stand up and eat, and the smell of freshly baked chocolate chip cookies wafts through the air. The tiles on the kitchen floor are faded and chipped from the sunlight. This is clearly the most popular room in the house. The living room is to the west of you.

You can see an Oven (closed) and a Cabinet (empty) here.

Sam arrives from the Living Room.

>w
Living Room
This room is largeish, with a bank of sunny windows next to the door to the patio facing the street outside. There are lots of places a cat could hide, especially a cat who does not want to go to the vet. The hallway is to the south, and the kitchen is to the east.

You can see a pappasan and a newspaper here.

Sam arrives from the Kitchen.

>s
Hallway
The carpet in the hallway is worn from the scuffling of furry cat feet as they run rapidly from room to room for no apparent reason. The bathroom is to the south and the living room is to the north. There are stairs here that lead up to the attic. The bedroom is to the west of the hallway.

You can see a cat carrier (empty) here.

Sam arrives from the Living Room.

>s
Bathroom
The bathroom is small, just large enough to hold a mirror, the sink, the shower, and the toilet.

Opposite the mirror is the shower, which is closed.

>i
You are carrying:
  a pair of Potholders (being worn)

>n
Hallway
The carpet in the hallway is worn from the scuffling of furry cat feet as they run rapidly from room to room for no apparent reason. The bathroom is to the south and the living room is to the north. There are stairs here that lead up to the attic. The bedroom is to the west of the hallway.

You can see Sam and a cat carrier (empty) here.

Sam heads to the Bathroom.

>n
Living Room
This room is largeish, with a bank of sunny windows next to the door to the patio facing the street outside. There are lots of places a cat could hide, especially a cat who does not want to go to the vet. The hallway is to the south, and the kitchen is to the east.

You can see a pappasan and a newspaper here.

>e
Kitchen
The kitchen is a bright, sunny room. A wraparound counter provides a place to stand up and eat, and the smell of freshly baked chocolate chip cookies wafts through the air. The tiles on the kitchen floor are faded and chipped from the sunlight. This is clearly the most popular room in the house. The living room is to the west of you.

You can see a tabby cat, an Oven (closed), and a Cabinet (empty) here.

You hear a horrible choking and hacking sound. Somewhere, someone has coughed up a hairball.

The large furry tabby cat leaves.

>w
Living Room
This room is largeish, with a bank of sunny windows next to the door to the patio facing the street outside. There are lots of places a cat could hide, especially a cat who does not want to go to the vet. The hallway is to the south, and the kitchen is to the east.

You can see a tabby cat, a pappasan, and a newspaper here.

The large furry tabby cat leaves.

>e
Kitchen
The kitchen is a bright, sunny room. A wraparound counter provides a place to stand up and eat, and the smell of freshly baked chocolate chip cookies wafts through the air. The tiles on the kitchen floor are faded and chipped from the sunlight. This is clearly the most popular room in the house. The living room is to the west of you.

You can see an Oven (closed) and a Cabinet (empty) here.

>w
Living Room
This room is largeish, with a bank of sunny windows next to the door to the patio facing the street outside. There are lots of places a cat could hide, especially a cat who does not want to go to the vet. The hallway is to the south, and the kitchen is to the east.

You can see a pappasan and a newspaper here.

>s
Hallway
The carpet in the hallway is worn from the scuffling of furry cat feet as they run rapidly from room to room for no apparent reason. The bathroom is to the south and the living room is to the north. There are stairs here that lead up to the attic. The bedroom is to the west of the hallway.

You can see Sam and a cat carrier (empty) here.

Sam heads to the Bathroom.

There is a large furry tabby cat here.

>take cat
Which do you mean, the tabby cat or the cat carrier?

>take tabby cat
Taken.

Sam arrives from the Bathroom.

The tabby cat kicks and squirms. It is hard to carry him.

>n
Living Room
This room is largeish, with a bank of sunny windows next to the door to the patio facing the street outside. There are lots of places a cat could hide, especially a cat who does not want to go to the vet. The hallway is to the south, and the kitchen is to the east.

You can see a pappasan and a newspaper here.

Sam arrives from the Hallway.

The tabby cat kicks and squirms. It is hard to carry him.
With a supreme effort and a baleful look, the tabby cat escapes from your grasp.

* * *

>s
Hallway
The carpet in the hallway is worn from the scuffling of furry cat feet as they run rapidly from room to room for no apparent reason. The bathroom is to the south and the living room is to the north. There are stairs here that lead up to the attic. The bedroom is to the west of the hallway.

You can see a cat carrier (empty) here.

Sam arrives from the Living Room.

>x tabby cat
The tabby cat is older and wiser than you. His fur is matted and tangled, with a pink nose and a prominent M on his forehead. He gazes at you with a look that is part interest, part contempt. He yawns.

>win
That's not a verb I recognise.

>e
You can't go that way.

Sam arrives from the Living Room.

>n
Living Room
This room is largeish, with a bank of sunny windows next to the door to the patio facing the street outside. There are lots of places a cat could hide -- especially a cat who does not want to go to the vet. The hallway is to the south, and the kitchen is to the east.

You can see a tabby cat, a newspaper and a pappasan here.

>e
Kitchen
The kitchen is a bright, sunny room. A wraparound counter provides a place to stand up and eat, and the smell of freshly baked chocolate chip cookies wafts through the air. The tiles on the kitchen floor are faded and chipped from the sunlight. This is clearly the most popular room in the house. The living room is to the west of you.

You can see a tabby cat, an Oven (closed) and a Cabinet (closed) here.

You hear a horrible choking and hacking sound. Somewhere, someone has coughed up a hairball.

>open oven
A blast of hot air and the aroma of soft, chewy chocolate chip cookies greets you as you peer eagerly into the hot oven.

You realize that you have only ten more minutes to get the cat into his carrier.

>take cookies
You'll need something to protect your hands!

You hear a horrible choking and hacking sound. Somewhere, someone has coughed up a hairball.

>open cabinet
You open the Cabinet, revealing a pair of Potholders.

You hear a horrible choking and hacking sound. Somewhere, someone has coughed up a hairball.

>take potholders.
[Your score has just gone up by one point.]

>wear potholders
You put on the pair of Potholders.

You hear a horrible choking and hacking sound. Somewhere, someone has coughed up a hairball.

>take cookies
Your exhaustion is threatening to send you crashing to the floor, unable to move.

[Your score has just gone up by one point.]

>e
You can't go that way.

>s
You can't go that way.

Sam arrives from the Living Room.

>s
You can't go that way.

You hear a horrible choking and hacking sound. Somewhere, someone has coughed up a hairball.

Sam heads to the Living Room.

>n
You can't go that way.

You hear a horrible choking and hacking sound. Somewhere, someone has coughed up a hairball.

Sam arrives from the Living Room.

>w
Living Room
This room is largeish, with a bank of sunny windows next to the door to the patio facing the street outside. There are lots of places a cat could hide -- especially a cat who does not want to go to the vet. The hallway is to the south, and the kitchen is to the east.

You can see a newspaper and a pappasan here.

Sam arrives from the Kitchen.

There is a large furry tabby cat here.

You are about to drop dead of exhaustion. You really should go sit down.

>take cat
Taken.

Sam heads to the Kitchen.

The tabby cat kicks and squirms. It is hard to carry him.

>s
Hallway
The carpet in the hallway is worn from the scuffling of furry cat feet as they run rapidly from room to room for no apparent reason. The bathroom is to the south and the living room is to the north. There are stairs here that lead up to the attic.

You can see a cat carrier (empty) here.

You hear a horrible choking and hacking sound. Somewhere, someone has coughed up a hairball.

The tabby cat kicks and squirms. It is hard to carry him.

You stumble to your knees and then collapse on the floor, quite surprised to find that the phrase "drop dead of exhaustion" can be literally true.

    *** You have died ***

In that game you scored 2 out of a possible 0, in 18 turns.

Would you like to RESTART, RESTORE a saved game, QUIT or UNDO the last command?

* * *

>s
Bathroom
The bathroom is small, just large enough to hold a mirror, the sink, the shower, and the toilet.

Opposite the mirror is the shower, which is closed.

>n
Hallway
The carpet in the hallway is worn from the scuffling of furry cat feet as they run rapidly from room to room for no apparent reason. The bathroom is to the south and the living room is to the north. There are stairs here that lead up to the attic.

You can see a tabby cat and a cat carrier (empty) here.

>n
Living Room
This room is largeish, with a bank of sunny windows next to the door to the patio facing the street outside. There are lots of places a cat could hide -- especially a cat who does not want to go to the vet. The hallway is to the south, and the kitchen is to the east.

You can see a newspaper and a pappasan here.

You hear a horrible choking and hacking sound. Somewhere, someone has coughed up a hairball.

Sam arrives from the Kitchen.

There is a large furry tabby cat here.

>x sam
Sam is a black and white cat.

Sam heads to the Kitchen.

[Your score has just gone up by one point.]

* * *

>s
Bathroom
The bathroom is small, just large enough to hold a mirror, the sink, the shower, and the toilet.

Opposite the mirror is the shower, which is closed.

>examine toilet
This is your litterbox. It needs a good cleaning. Now is probably not the best time.

[Your score has just gone up by one point.]